width = 5632
height = 2048

max_provinces = 2591
sea_starts = {
	1076 1297 1470 1472 1473 1474 1475 1476 1477 1478 1479 1480 1481 1482
	1483 1484 1485 1486 1487 1488 1489 1490 1491 1492 1493 1494 1495 1496
	1497 1498 1499 2281 2282 2283 2284 2285 2286 2287 2288 2289 2290 2291
	2292 2293 2294 2295 2296 2297 2298 2299 2300 2301 2302 2303 2304 2305
	2306 2307 2308 2309 2310 2311 2312 2313 2314 2315 2316 2317 2318 2319
	2320 2321 2322 2323 2324 2325 2326 2327 2328 2329 2330 2331 2332 2333
	2334 2335 2336 2337 2338 2339 2340 2341 2342 2343 2344 2345 2346 2347
	2348 2349 2350 2351 2352 2353 2354 2355 2356 2357 2358 2359 2360 2361
	2362 2363 2364 2365 2366 2367 2368 2369 2370 2371 2372 2373 2374 2375
	2376 2377 2378 2379 2380 2381 2382 2383 2384 2385 2386 2387 2388 2389
	2390 2391 2392 2393 2394 2395 2396 2397 2398 2399 2400 2401 2402 2403
	2404 2405 2406 2407 2408 2409 2410 2411 2412 2413 2414 2415 2416 2417
	2418 2419 2420 2421 2422 2423 2424 2425 2426 2427 2428 2429 2430 2431
	2432 2433 2434 2435 2436 2437 2438 2439 2440 2441 2442 2443 2444 2445
	2446 2447 2448 2449 2450 2451 2452 2453 2454 2455 2456 2457 2458 2459
	2460 2461 2462 2463 2464 2465 2466 2467 2468 2469 2470 2471 2472 2473
	2474 2475 2476 2477 2478 2479 2480 2481 2482 2483 2484 2485 2486 2487
	2488 2489 2490 2491 2492 2493 2494 2495 2496 2497 2498 2499 2500 2501
	2502 2503 2504 2505 2506 2507 2508 2509 2510 2511 2512 2513 2514 2515
	2516 2517 2518 2519 2520 2521 2522 2523 2524 2525 2526 2527 2528 2529
	2530 2531 2531 2532 2533 2534 2535 2536 2537 2538 2539 2540 2541 2542
	2543 2544 2545 2546 2547 2548 2549 2550 2551 2552 2553 2554 2555 2556
	2557 2558 2559 2560 2561 2562 2563 2564 2565 2566 2567 2568 2569 2570
	2571 2572 2573 2574 2575 2576 2577 2578 2579 2580 2581 2582 2583 2584
	2585 2586 2587 2588
}

lakes = {

}

force_coastal = {

}

definitions = "definition.csv"
provinces = "provinces.bmp"
positions = "positions.txt"
terrain = "terrain.bmp"
rivers = "rivers.bmp"
terrain_definition = "terrain.txt"
heightmap = "heightmap.bmp"
tree_definition = "trees.bmp"
continent = "continent.txt"
adjacencies = "adjacencies.csv"
climate = "climate.txt"
region = "region.txt"
superregion = "superregion.txt"
area = "area.txt"
provincegroup = "provincegroup.txt"
ambient_object = "ambient_object.txt"
seasons = "seasons.txt"
trade_winds = "trade_winds.txt"
canal_definition = {
	name = "piltover_canal"
	x = 3059
	y = 1038
}

# Define which indices in trees.bmp palette which should count as trees for automatic terrain assignment
tree = { 3 4 7 10 }
